...#...#....
.##..#...#.#
..#.###...#.
.#...#..##..
...#.#...#..
#.#..###.##.
#...#.....#.
.#..#..##..#
..##..##..##
#..#.#..##..
......#..#..
##.#........
